0 18 19 19 18 19 20 18 18 19 20 18 19 19 18 1
17 4 12 13 13 13 12 12 13 12 12 12 13 12 5 14
16 9 23 26 29 25 27 26 28 23 24 29 27 28 8 15
16 9 26 28 23 26 29 25 27 24 29 23 27 23 8 15
17 9 29 23 26 25 27 24 26 28 29 23 27 25 8 14
17 9 25 29 23 27 25 29 27 24 26 28 23 26 8 15
16 9 27 25 29 25 29 23 24 26 28 23 26 27 8 14
17 9 28 29 23 26 27 25 27 25 29 23 24 26 8 14
16 9 23 29 23 27 25 27 26 28 29 25 24 26 8 14
16 9 24 26 23 27 25 27 26 28 29 23 29 25 8 15
17 6 10 11 11 10 10 10 11 10 11 11 10 10 7 14
2 21 22 21 22 22 21 22 21 21 22 21 22 22 21 3