1 3 3 3 3 3 3 3 3 3 2 0 0 0 0 0 0 0 0 0 0 0 0 0 0 0 0 0 0 0 0 0
1 5 5 5 5 5 5 5 5 5 2 0 0 0 0 0 0 0 0 0 0 0 0 0 0 0 0 0 0 0 0 0
1 5 5 5 5 5 5 5 5 5 2 0 0 0 0 0 0 0 0 0 0 0 0 1 3 3 3 3 3 3 3 2
1 5 5 5 5 5 5 5 5 5 2 0 0 0 0 0 0 0 0 0 0 0 0 1 5 5 5 5 5 5 5 2
1 5 5 5 5 5 5 5 5 5 3 3 3 3 3 3 3 3 3 3 3 3 3 3 5 5 5 5 5 5 5 2
1 5 5 5 5 5 5 5 5 5 5 5 5 5 5 5 5 5 5 5 5 5 5 5 5 5 5 5 5 5 5 2
1 5 5 5 5 5 5 5 5 5 5 5 5 5 5 5 5 5 5 5 5 5 5 5 5 5 5 5 5 5 5 2
1 5 5 5 5 5 5 5 5 5 9 4 4 4 8 5 5 9 4 4 4 4 4 4 4 4 4 4 4 4 4 7
1 5 5 5 5 5 5 5 5 5 2 0 0 0 1 5 5 2 0 0 0 0 0 0 0 0 0 0 0 0 0 0
6 4 4 4 4 4 4 4 4 4 7 0 0 0 1 5 5 2 0 0 0 0 0 0 0 0 0 0 0 0 0 0
0 0 0 0 0 0 0 0 0 0 0 0 0 0 1 5 5 2 0 0 0 0 0 0 0 0 0 0 0 0 0 0
0 0 0 0 0 0 0 0 0 0 0 0 0 0 1 5 5 2 0 0 0 0 0 0 0 0 0 0 0 0 0 0
0 0 0 0 0 0 0 0 0 1 3 3 3 3 3 5 5 3 3 3 3 3 2 0 0 0 0 0 0 0 0 0
0 0 0 0 0 0 0 0 0 1 5 5 5 5 5 5 5 5 5 5 5 5 2 0 0 0 0 0 0 0 0 0
0 0 0 0 0 0 0 0 0 1 5 5 5 5 5 5 5 5 5 5 5 5 2 0 0 0 0 0 0 0 0 0
0 0 0 0 0 0 0 0 0 1 5 5 5 5 5 5 5 5 5 5 5 5 2 0 0 0 0 0 0 0 0 0
0 0 0 0 0 0 0 0 0 1 5 5 5 5 5 5 5 5 5 5 5 5 2 0 0 0 0 0 0 0 0 0
0 0 0 0 0 0 0 0 0 1 5 5 5 5 5 5 5 5 5 5 5 5 2 0 0 0 0 0 0 0 0 0
0 0 0 0 0 0 0 0 0 1 5 5 5 5 5 5 5 5 5 5 5 5 2 0 0 0 0 0 0 0 0 0
0 0 0 0 0 0 0 0 0 1 5 5 5 5 5 5 5 5 5 5 5 5 2 0 0 0 0 0 0 0 0 0
0 0 0 0 0 0 0 0 0 1 5 5 5 5 5 5 5 5 5 5 5 5 2 0 0 0 0 0 0 0 0 0
0 0 0 0 0 0 0 0 0 1 5 5 5 5 5 5 5 5 5 5 5 5 2 0 0 0 0 0 0 0 0 0
0 0 0 0 0 0 0 0 0 6 4 4 4 4 4 4 4 4 4 4 4 4 7 0 0 0 0 0 0 0 0 0
0 0 0 0 0 0 0 0 0 0 0 0 0 0 0 0 0 0 0 0 0 0 0 0 0 0 0 0 0 0 0 0
0 0 0 0 0 0 0 0 0 0 0 0 0 0 0 0 0 0 0 0 0 0 0 0 0 0 0 0 0 0 0 0
0 0 0 0 0 0 0 0 0 0 0 0 0 0 0 0 0 0 0 0 0 0 0 0 0 0 0 0 0 0 0 0
0 0 0 0 0 0 0 0 0 0 0 0 0 0 0 0 0 0 0 0 0 0 0 0 0 0 0 0 0 0 0 0
0 0 0 0 0 0 0 0 0 0 0 0 0 0 0 0 0 0 0 0 0 0 0 0 0 0 0 0 0 0 0 0
0 0 0 0 0 0 0 0 0 0 0 0 0 0 0 0 0 0 0 0 0 0 0 0 0 0 0 0 0 0 0 0
0 0 0 0 0 0 0 0 0 0 0 0 0 0 0 0 0 0 0 0 0 0 0 0 0 0 0 0 0 0 0 0
0 0 0 0 0 0 0 0 0 0 0 0 0 0 0 0 0 0 0 0 0 0 0 0 0 0 0 0 0 0 0 0
0 0 0 0 0 0 0 0 0 0 0 0 0 0 0 0 0 0 0 0 0 0 0 0 0 0 0 0 0 0 0 0